area_id,area_name,b99104001,b99104001_moe,b99104002,b99104002_moe,b99104003,b99104003_moe,b99104004,b99104004_moe,b99104005,b99104005_moe,b99104006,b99104006_moe,b99104007,b99104007_moe
BK09,Brooklyn Heights-Cobble Hill,15794,-1,124,-1,0,-1,0,-1,0,-1,124,-1,15670,-1
BK17,Sheepshead Bay-Gerritsen Beach-Manhattan Beach,41856,-1,1109,-1,222,-1,18,-1,204,-1,887,-1,40747,-1
BK19,Brighton Beach,21630,-1,486,-1,163,-1,7,-1,156,-1,323,-1,21144,-1
BK21,Seagate-Coney Island,18667,-1,920,-1,428,-1,71,-1,357,-1,492,-1,17747,-1
BK23,West Brighton,12676,-1,282,-1,117,-1,7,-1,110,-1,165,-1,12394,-1
BK25,Homecrest,25275,-1,584,-1,196,-1,51,-1,145,-1,388,-1,24691,-1
BK26,Gravesend,18685,-1,839,-1,244,-1,53,-1,191,-1,595,-1,17846,-1
BK27,Bath Beach,19035,-1,727,-1,181,-1,39,-1,142,-1,546,-1,18308,-1
BK28,Bensonhurst West,53284,-1,2219,-1,485,-1,172,-1,313,-1,1734,-1,51065,-1
BK29,Bensonhurst East,39352,-1,2178,-1,878,-1,137,-1,741,-1,1300,-1,37174,-1
BK30,Dyker Heights,27952,-1,1691,-1,771,-1,72,-1,699,-1,920,-1,26261,-1
BK31,Bay Ridge,53135,-1,1029,-1,308,-1,48,-1,260,-1,721,-1,52106,-1
BK32,Sunset Park West,28848,-1,1724,-1,679,-1,66,-1,613,-1,1045,-1,27124,-1
BK33,Carroll Gardens-Columbia Street-Red Hook,25240,-1,378,-1,228,-1,43,-1,185,-1,150,-1,24862,-1
BK34,Sunset Park East,38596,-1,2698,-1,1068,-1,250,-1,818,-1,1630,-1,35898,-1
BK35,Stuyvesant Heights,35793,-1,2708,-1,1073,-1,182,-1,891,-1,1635,-1,33085,-1
BK37,Park Slope-Gowanus,44857,-1,730,-1,351,-1,65,-1,286,-1,379,-1,44127,-1
BK38,DUMBO-Vinegar Hill-Downtown Brooklyn-Boerum Hill,21843,-1,621,-1,334,-1,9,-1,325,-1,287,-1,21222,-1
BK40,Windsor Terrace,14524,-1,310,-1,129,-1,0,-1,129,-1,181,-1,14214,-1
BK41,Kensington-Ocean Parkway,19777,-1,674,-1,252,-1,38,-1,214,-1,422,-1,19103,-1
BK42,Flatbush,59164,-1,3128,-1,1388,-1,350,-1,1038,-1,1740,-1,56036,-1
BK43,Midwood,29030,-1,427,-1,152,-1,20,-1,132,-1,275,-1,28603,-1
BK44,Madison,25506,-1,942,-1,110,-1,18,-1,92,-1,832,-1,24564,-1
BK45,Georgetown-Marine Park-Bergen Beach-Mill Basin,29371,-1,1066,-1,291,-1,48,-1,243,-1,775,-1,28305,-1
BK46,Ocean Parkway South,10436,-1,209,-1,55,-1,37,-1,18,-1,154,-1,10227,-1
BK50,Canarsie,49528,-1,3312,-1,934,-1,253,-1,681,-1,2378,-1,46216,-1
BK58,Flatlands,41421,-1,2558,-1,999,-1,214,-1,785,-1,1559,-1,38863,-1
BK60,Prospect Lefferts Gardens-Wingate,40260,-1,2209,-1,1052,-1,237,-1,815,-1,1157,-1,38051,-1
BK61,Crown Heights North,56451,-1,2513,-1,1099,-1,259,-1,840,-1,1414,-1,53938,-1
BK63,Crown Heights South,21258,-1,1204,-1,332,-1,157,-1,175,-1,872,-1,20054,-1
BK64,Prospect Heights,12860,-1,242,-1,55,-1,21,-1,34,-1,187,-1,12618,-1
BK68,Fort Greene,15850,-1,529,-1,221,-1,46,-1,175,-1,308,-1,15321,-1
BK69,Clinton Hill,20351,-1,725,-1,232,-1,64,-1,168,-1,493,-1,19626,-1
BK72,Williamsburg,10696,-1,368,-1,178,-1,47,-1,131,-1,190,-1,10328,-1
BK73,North Side-South Side,24471,-1,872,-1,283,-1,36,-1,247,-1,589,-1,23599,-1
BK75,Bedford,33313,-1,1973,-1,655,-1,242,-1,413,-1,1318,-1,31340,-1
BK76,Greenpoint,19634,-1,176,-1,57,-1,23,-1,34,-1,119,-1,19458,-1
BK77,Bushwick North,29716,-1,1962,-1,724,-1,198,-1,526,-1,1238,-1,27754,-1
BK78,Bushwick South,36030,-1,2817,-1,1198,-1,360,-1,838,-1,1619,-1,33213,-1
BK79,Ocean Hill,16399,-1,1206,-1,458,-1,83,-1,375,-1,748,-1,15193,-1
BK81,Brownsville,27538,-1,2043,-1,910,-1,52,-1,858,-1,1133,-1,25495,-1
BK82,East New York,47138,-1,4080,-1,1204,-1,436,-1,768,-1,2876,-1,43058,-1
BK83,Cypress Hills-City Line,24477,-1,2060,-1,490,-1,195,-1,295,-1,1570,-1,22417,-1
BK85,East New York (Pennsylvania Ave),14028,-1,1170,-1,407,-1,65,-1,342,-1,763,-1,12858,-1
BK88,Borough Park,46640,-1,1389,-1,625,-1,309,-1,316,-1,764,-1,45251,-1
BK90,East Williamsburg,19788,-1,575,-1,246,-1,132,-1,114,-1,329,-1,19213,-1
BK91,East Flatbush-Farragut,31933,-1,2673,-1,784,-1,132,-1,652,-1,1889,-1,29260,-1
BK93,Starrett City,8089,-1,598,-1,339,-1,27,-1,312,-1,259,-1,7491,-1
BK95,Erasmus,16824,-1,1245,-1,525,-1,77,-1,448,-1,720,-1,15579,-1
BK96,Rugby-Remsen Village,33782,-1,2508,-1,962,-1,201,-1,761,-1,1546,-1,31274,-1
BK99,park-cemetery-etc-Brooklyn,209,-1,11,-1,11,-1,0,-1,11,-1,0,-1,198,-1
BX01,Claremont-Bathgate,14134,-1,1049,-1,437,-1,170,-1,267,-1,612,-1,13085,-1
BX03,Eastchester-Edenwald-Baychester,19786,-1,1526,-1,607,-1,121,-1,486,-1,919,-1,18260,-1
BX05,Bedford Park-Fordham North,27599,-1,1754,-1,600,-1,88,-1,512,-1,1154,-1,25845,-1
BX06,Belmont,10840,-1,530,-1,97,-1,0,-1,97,-1,433,-1,10310,-1
BX07,Bronxdale,19717,-1,922,-1,422,-1,110,-1,312,-1,500,-1,18795,-1
BX08,West Farms-Bronx River,17932,-1,854,-1,224,-1,50,-1,174,-1,630,-1,17078,-1
BX09,Soundview-Castle Hill-Clason Point-Harding Park,30260,-1,1675,-1,591,-1,145,-1,446,-1,1084,-1,28585,-1
BX10,Pelham Bay-Country Club-City Island,18018,-1,450,-1,144,-1,79,-1,65,-1,306,-1,17568,-1
BX13,Co-op City,30122,-1,1324,-1,487,-1,70,-1,417,-1,837,-1,28798,-1
BX14,East Concourse-Concourse Village,33549,-1,2312,-1,800,-1,93,-1,707,-1,1512,-1,31237,-1
BX17,East Tremont,20434,-1,1451,-1,660,-1,83,-1,577,-1,791,-1,18983,-1
BX22,North Riverdale-Fieldston-Riverdale,17159,-1,212,-1,35,-1,0,-1,35,-1,177,-1,16947,-1
BX26,Highbridge,18690,-1,1088,-1,502,-1,76,-1,426,-1,586,-1,17602,-1
BX27,Hunts Point,13015,-1,774,-1,369,-1,11,-1,358,-1,405,-1,12241,-1
BX28,Van Cortlandt Village,28449,-1,1629,-1,505,-1,142,-1,363,-1,1124,-1,26820,-1
BX29,Spuyten Duyvil-Kingsbridge,20052,-1,284,-1,89,-1,10,-1,79,-1,195,-1,19768,-1
BX30,Kingsbridge Heights,16817,-1,969,-1,360,-1,15,-1,345,-1,609,-1,15848,-1
BX31,Allerton-Pelham Gardens,20889,-1,1324,-1,209,-1,51,-1,158,-1,1115,-1,19565,-1
BX33,Longwood,11986,-1,874,-1,297,-1,70,-1,227,-1,577,-1,11112,-1
BX34,Melrose South-Mott Haven North,17836,-1,1570,-1,628,-1,109,-1,519,-1,942,-1,16266,-1
BX35,Morrisania-Melrose,18633,-1,1632,-1,606,-1,132,-1,474,-1,1026,-1,17001,-1
BX36,University Heights-Morris Heights,27317,-1,2154,-1,745,-1,152,-1,593,-1,1409,-1,25163,-1
BX37,Van Nest-Morris Park-Westchester Square,16830,-1,630,-1,66,-1,44,-1,22,-1,564,-1,16200,-1
BX39,Mott Haven-Port Morris,25856,-1,1390,-1,601,-1,106,-1,495,-1,789,-1,24466,-1
BX40,Fordham South,11865,-1,1117,-1,328,-1,57,-1,271,-1,789,-1,10748,-1
BX41,Mount Hope,26631,-1,1797,-1,720,-1,216,-1,504,-1,1077,-1,24834,-1
BX43,Norwood,21387,-1,1569,-1,614,-1,96,-1,518,-1,955,-1,19818,-1
BX44,Williamsbridge-Olinville,33978,-1,2145,-1,815,-1,163,-1,652,-1,1330,-1,31833,-1
BX46,Parkchester,18176,-1,781,-1,116,-1,10,-1,106,-1,665,-1,17395,-1
BX49,Pelham Parkway,18975,-1,1043,-1,245,-1,16,-1,229,-1,798,-1,17932,-1
BX52,Schuylerville-Throgs Neck-Edgewater Park,27852,-1,807,-1,210,-1,30,-1,180,-1,597,-1,27045,-1
BX55,Soundview-Bruckner,18624,-1,1246,-1,620,-1,283,-1,337,-1,626,-1,17378,-1
BX59,Westchester-Unionport,14644,-1,920,-1,231,-1,102,-1,129,-1,689,-1,13724,-1
BX62,Woodlawn-Wakefield,26875,-1,2019,-1,745,-1,116,-1,629,-1,1274,-1,24856,-1
BX63,West Concourse,20381,-1,1280,-1,516,-1,122,-1,394,-1,764,-1,19101,-1
BX75,Crotona Park East,9672,-1,552,-1,301,-1,29,-1,272,-1,251,-1,9120,-1
BX98,Rikers Island,4676,-1,0,-1,0,-1,0,-1,0,-1,0,-1,4676,-1
BX99,park-cemetery-etc-Bronx,801,-1,45,-1,5,-1,0,-1,5,-1,40,-1,756,-1
MN01,Marble Hill-Inwood,29909,-1,1641,-1,415,-1,69,-1,346,-1,1226,-1,28268,-1
MN03,Central Harlem North-Polo Grounds,45284,-1,2088,-1,1067,-1,183,-1,884,-1,1021,-1,43196,-1
MN04,Hamilton Heights,28601,-1,1534,-1,924,-1,201,-1,723,-1,610,-1,27067,-1
MN06,Manhattanville,12614,-1,561,-1,280,-1,9,-1,271,-1,281,-1,12053,-1
MN09,Morningside Heights,27286,-1,431,-1,177,-1,9,-1,168,-1,254,-1,26855,-1
MN11,Central Harlem South,26081,-1,1064,-1,435,-1,88,-1,347,-1,629,-1,25017,-1
MN12,Upper West Side,93546,-1,1416,-1,342,-1,46,-1,296,-1,1074,-1,92130,-1
MN13,Hudson Yards-Chelsea-Flat Iron-Union Square,47179,-1,434,-1,162,-1,2,-1,160,-1,272,-1,46745,-1
MN14,Lincoln Square,42286,-1,398,-1,187,-1,0,-1,187,-1,211,-1,41888,-1
MN15,Clinton,28317,-1,176,-1,94,-1,51,-1,43,-1,82,-1,28141,-1
MN17,Midtown-Midtown South,17992,-1,35,-1,0,-1,0,-1,0,-1,35,-1,17957,-1
MN19,Turtle Bay-East Midtown,34023,-1,26,-1,25,-1,25,-1,0,-1,1,-1,33997,-1
MN20,Murray Hill-Kips Bay,28222,-1,364,-1,170,-1,78,-1,92,-1,194,-1,27858,-1
MN21,Gramercy,16170,-1,0,-1,0,-1,0,-1,0,-1,0,-1,16170,-1
MN22,East Village,24409,-1,228,-1,83,-1,0,-1,83,-1,145,-1,24181,-1
MN23,West Village,42895,-1,356,-1,33,-1,14,-1,19,-1,323,-1,42539,-1
MN24,SoHo-TriBeCa-Civic Center-Little Italy,24046,-1,507,-1,37,-1,0,-1,37,-1,470,-1,23539,-1
MN25,Battery Park City-Lower Manhattan,21564,-1,62,-1,0,-1,0,-1,0,-1,62,-1,21502,-1
MN27,Chinatown,30364,-1,1160,-1,247,-1,38,-1,209,-1,913,-1,29204,-1
MN28,Lower East Side,48547,-1,2622,-1,569,-1,168,-1,401,-1,2053,-1,45925,-1
MN31,Lenox Hill-Roosevelt Island,55113,-1,182,-1,58,-1,33,-1,25,-1,124,-1,54931,-1
MN32,Yorkville,51786,-1,293,-1,94,-1,76,-1,18,-1,199,-1,51493,-1
MN33,East Harlem South,34572,-1,1585,-1,706,-1,91,-1,615,-1,879,-1,32987,-1
MN34,East Harlem North,31512,-1,2092,-1,941,-1,134,-1,807,-1,1151,-1,29420,-1
MN35,Washington Heights North,42013,-1,2304,-1,637,-1,142,-1,495,-1,1667,-1,39709,-1
MN36,Washington Heights South,52635,-1,3314,-1,1181,-1,155,-1,1026,-1,2133,-1,49321,-1
MN40,Upper East Side-Carnegie Hill,42156,-1,203,-1,57,-1,0,-1,57,-1,146,-1,41953,-1
MN50,Stuyvesant Town-Cooper Village,13743,-1,144,-1,41,-1,0,-1,41,-1,103,-1,13599,-1
MN99,park-cemetery-etc-Manhattan,1269,-1,0,-1,0,-1,0,-1,0,-1,0,-1,1269,-1
QN01,South Jamaica,20039,-1,1689,-1,631,-1,106,-1,525,-1,1058,-1,18350,-1
QN02,Springfield Gardens North,16787,-1,1345,-1,516,-1,67,-1,449,-1,829,-1,15442,-1
QN03,Springfield Gardens South-Brookville,11183,-1,837,-1,110,-1,12,-1,98,-1,727,-1,10346,-1
QN05,Rosedale,15619,-1,1711,-1,548,-1,137,-1,411,-1,1163,-1,13908,-1
QN06,Jamaica Estates-Holliswood,16950,-1,613,-1,72,-1,19,-1,53,-1,541,-1,16337,-1
QN07,Hollis,12602,-1,1046,-1,161,-1,33,-1,128,-1,885,-1,11556,-1
QN08,St. Albans,30838,-1,2396,-1,641,-1,197,-1,444,-1,1755,-1,28442,-1
QN10,Breezy Point-Belle Harbor-Rockaway Park-Broad Channel,19876,-1,325,-1,62,-1,0,-1,62,-1,263,-1,19551,-1
QN12,Hammels-Arverne-Edgemere,19301,-1,1163,-1,522,-1,181,-1,341,-1,641,-1,18138,-1
QN15,Far Rockaway-Bayswater,26384,-1,1328,-1,445,-1,6,-1,439,-1,883,-1,25056,-1
QN17,Forest Hills,58692,-1,1043,-1,280,-1,55,-1,225,-1,763,-1,57649,-1
QN18,Rego Park,18908,-1,495,-1,202,-1,23,-1,179,-1,293,-1,18413,-1
QN19,Glendale,19472,-1,1250,-1,187,-1,59,-1,128,-1,1063,-1,18222,-1
QN20,Ridgewood,39102,-1,1703,-1,452,-1,123,-1,329,-1,1251,-1,37399,-1
QN21,Middle Village,26999,-1,675,-1,42,-1,0,-1,42,-1,633,-1,26324,-1
QN22,Flushing,46667,-1,2227,-1,675,-1,231,-1,444,-1,1552,-1,44440,-1
QN23,College Point,15236,-1,1008,-1,186,-1,59,-1,127,-1,822,-1,14228,-1
QN25,Corona,30001,-1,1910,-1,519,-1,47,-1,472,-1,1391,-1,28091,-1
QN26,North Corona,25436,-1,1665,-1,427,-1,79,-1,348,-1,1238,-1,23771,-1
QN27,East Elmhurst,12981,-1,954,-1,146,-1,57,-1,89,-1,808,-1,12027,-1
QN28,Jackson Heights,64574,-1,2880,-1,554,-1,109,-1,445,-1,2326,-1,61694,-1
QN29,Elmhurst,51735,-1,2565,-1,526,-1,128,-1,398,-1,2039,-1,49170,-1
QN30,Maspeth,17926,-1,517,-1,297,-1,169,-1,128,-1,220,-1,17409,-1
QN31,Hunters Point-Sunnyside-West Maspeth,38726,-1,1120,-1,227,-1,40,-1,187,-1,893,-1,37606,-1
QN33,Cambria Heights,13426,-1,827,-1,202,-1,43,-1,159,-1,625,-1,12599,-1
QN34,Queens Village,34962,-1,2748,-1,631,-1,59,-1,572,-1,2117,-1,32214,-1
QN35,Briarwood-Jamaica Hills,24219,-1,1572,-1,320,-1,108,-1,212,-1,1252,-1,22647,-1
QN37,Kew Gardens Hills,21126,-1,987,-1,278,-1,0,-1,278,-1,709,-1,20139,-1
QN38,Pomonok-Flushing Heights-Hillcrest,19764,-1,1136,-1,245,-1,16,-1,229,-1,891,-1,18628,-1
QN41,Fresh Meadows-Utopia,11130,-1,455,-1,28,-1,0,-1,28,-1,427,-1,10675,-1
QN42,Oakland Gardens,19037,-1,520,-1,30,-1,0,-1,30,-1,490,-1,18517,-1
QN43,Bellerose,16278,-1,831,-1,149,-1,27,-1,122,-1,682,-1,15447,-1
QN44,Glen Oaks-Floral Park-New Hyde Park,15687,-1,527,-1,69,-1,0,-1,69,-1,458,-1,15160,-1
QN45,Douglas Manor-Douglaston-Little Neck,17500,-1,575,-1,116,-1,49,-1,67,-1,459,-1,16925,-1
QN46,Bayside-Bayside Hills,30136,-1,1008,-1,190,-1,13,-1,177,-1,818,-1,29128,-1
QN47,Ft. Totten-Bay Terrace-Clearview,16698,-1,220,-1,4,-1,0,-1,4,-1,216,-1,16478,-1
QN48,Auburndale,13471,-1,527,-1,51,-1,24,-1,27,-1,476,-1,12944,-1
QN49,Whitestone,21108,-1,637,-1,214,-1,48,-1,166,-1,423,-1,20471,-1
QN50,Elmhurst-Maspeth,16403,-1,776,-1,132,-1,0,-1,132,-1,644,-1,15627,-1
QN51,Murray Hill,33970,-1,1552,-1,321,-1,97,-1,224,-1,1231,-1,32418,-1
QN52,East Flushing,18404,-1,1104,-1,103,-1,16,-1,87,-1,1001,-1,17300,-1
QN53,Woodhaven,32340,-1,2624,-1,631,-1,92,-1,539,-1,1993,-1,29716,-1
QN54,Richmond Hill,36980,-1,2864,-1,807,-1,107,-1,700,-1,2057,-1,34116,-1
QN55,South Ozone Park,46992,-1,4130,-1,1112,-1,162,-1,950,-1,3018,-1,42862,-1
QN56,Ozone Park,12837,-1,777,-1,159,-1,81,-1,78,-1,618,-1,12060,-1
QN57,Lindenwood-Howard Beach,20037,-1,636,-1,108,-1,37,-1,71,-1,528,-1,19401,-1
QN60,Kew Gardens,14779,-1,586,-1,39,-1,0,-1,39,-1,547,-1,14193,-1
QN61,Jamaica,29897,-1,1907,-1,535,-1,129,-1,406,-1,1372,-1,27990,-1
QN62,Queensboro Hill,12989,-1,681,-1,36,-1,28,-1,8,-1,645,-1,12308,-1
QN63,Woodside,28024,-1,885,-1,235,-1,31,-1,204,-1,650,-1,27139,-1
QN66,Laurelton,15803,-1,1194,-1,467,-1,87,-1,380,-1,727,-1,14609,-1
QN68,Queensbridge-Ravenswood-Long Island City,10161,-1,365,-1,96,-1,28,-1,68,-1,269,-1,9796,-1
QN70,Astoria,46541,-1,1170,-1,298,-1,114,-1,184,-1,872,-1,45371,-1
QN71,Old Astoria,14957,-1,431,-1,120,-1,0,-1,120,-1,311,-1,14526,-1
QN72,Steinway,30553,-1,490,-1,83,-1,34,-1,49,-1,407,-1,30063,-1
QN76,Baisley Park,19306,-1,1771,-1,715,-1,240,-1,475,-1,1056,-1,17535,-1
QN98,Airport,0,-1,0,-1,0,-1,0,-1,0,-1,0,-1,0,-1
QN99,park-cemetery-etc-Queens,290,-1,15,-1,0,-1,0,-1,0,-1,15,-1,275,-1
SI01,Annadale-Huguenot-Prince's Bay-Eltingville,18160,-1,524,-1,160,-1,16,-1,144,-1,364,-1,17636,-1
SI05,New Springville-Bloomfield-Travis,25533,-1,1129,-1,207,-1,28,-1,179,-1,922,-1,24404,-1
SI07,Westerleigh,15818,-1,346,-1,29,-1,8,-1,21,-1,317,-1,15472,-1
SI08,Grymes Hill-Clifton-Fox Hills,11995,-1,865,-1,101,-1,0,-1,101,-1,764,-1,11130,-1
SI11,Charleston-Richmond Valley-Tottenville,14598,-1,632,-1,150,-1,12,-1,138,-1,482,-1,13966,-1
SI12,Mariner's Harbor-Arlington-Port Ivory-Graniteville,16164,-1,820,-1,268,-1,13,-1,255,-1,552,-1,15344,-1
SI14,Grasmere-Arrochar-Ft. Wadsworth,9252,-1,365,-1,88,-1,0,-1,88,-1,277,-1,8887,-1
SI22,West New Brighton-New Brighton-St. George,17140,-1,688,-1,196,-1,14,-1,182,-1,492,-1,16452,-1
SI24,Todt Hill-Emerson Hill-Heartland Village-Lighthouse Hill,20878,-1,782,-1,299,-1,121,-1,178,-1,483,-1,20096,-1
SI25,Oakwood-Oakwood Beach,14410,-1,479,-1,135,-1,14,-1,121,-1,344,-1,13931,-1
SI28,Port Richmond,10851,-1,484,-1,155,-1,52,-1,103,-1,329,-1,10367,-1
SI32,Rossville-Woodrow,12225,-1,170,-1,24,-1,0,-1,24,-1,146,-1,12055,-1
SI35,New Brighton-Silver Lake,10896,-1,446,-1,227,-1,61,-1,166,-1,219,-1,10450,-1
SI36,Old Town-Dongan Hills-South Beach,15825,-1,927,-1,168,-1,14,-1,154,-1,759,-1,14898,-1
SI37,Stapleton-Rosebank,15126,-1,838,-1,325,-1,40,-1,285,-1,513,-1,14288,-1
SI45,New Dorp-Midland Beach,13531,-1,472,-1,52,-1,6,-1,46,-1,420,-1,13059,-1
SI48,Arden Heights,15482,-1,323,-1,52,-1,15,-1,37,-1,271,-1,15159,-1
SI54,Great Kills,27699,-1,1033,-1,238,-1,45,-1,193,-1,795,-1,26666,-1
SI99,park-cemetery-etc-Staten Island,0,-1,0,-1,0,-1,0,-1,0,-1,0,-1,0,-1
