area_id,area_name,c18121001,c18121001_moe,c18121002,c18121002_moe,c18121003,c18121003_moe,c18121004,c18121004_moe,c18121005,c18121005_moe,c18121006,c18121006_moe,c18121007,c18121007_moe,c18121008,c18121008_moe,c18121009,c18121009_moe,c18121010,c18121010_moe
BK09,Brooklyn Heights-Cobble Hill,17611,917,10148,626,297,168,9851,616,4240,547,224,120,4016,538,3223,537,378,182,2845,509
BK17,Sheepshead Bay-Gerritsen Beach-Manhattan Beach,38792,1226,20505,905,413,129,20092,905,7104,633,542,177,6562,607,11183,766,2097,309,9086,729
BK19,Brighton Beach,19508,975,9772,673,144,68,9628,672,3577,444,220,103,3357,433,6159,641,931,246,5228,590
BK21,Seagate-Coney Island,17294,992,6555,612,360,131,6195,610,4019,473,187,80,3832,468,6720,675,1674,309,5046,597
BK23,West Brighton,8157,749,4680,589,250,100,4430,588,1487,283,216,109,1271,261,1990,347,515,168,1475,310
BK25,Homecrest,24789,987,11600,655,427,161,11173,654,5518,500,192,82,5326,493,7671,550,969,193,6702,524
BK26,Gravesend,16315,890,7891,606,291,99,7600,607,3313,440,352,124,2961,412,5111,496,1015,229,4096,460
BK27,Bath Beach,18358,989,8873,661,214,93,8659,652,3855,454,166,82,3689,441,5630,526,856,185,4774,480
BK28,Bensonhurst West,55182,1636,26508,1098,457,134,26051,1082,12169,791,556,142,11613,784,16505,869,2046,297,14459,835
BK29,Bensonhurst East,39244,1288,19311,895,322,114,18989,891,8772,637,330,115,8442,631,11161,691,1358,219,9803,670
BK30,Dyker Heights,28612,1115,14375,798,201,84,14174,801,6439,547,252,98,6187,542,7798,646,1128,215,6670,595
BK31,Bay Ridge,54687,1358,28465,949,647,163,27818,948,11989,707,682,169,11307,696,14233,898,2231,386,12002,817
BK32,Sunset Park West,35355,1225,17018,869,355,123,16663,877,9512,760,385,126,9127,754,8825,611,1288,235,7537,561
BK33,Carroll Gardens-Columbia Street-Red Hook,27492,1001,15454,751,302,102,15152,754,7093,605,271,111,6822,597,4945,580,1286,311,3659,503
BK34,Sunset Park East,48018,1557,19808,990,438,133,19370,986,14507,922,540,165,13967,896,13703,838,1807,284,11896,804
BK35,Stuyvesant Heights,41769,1417,19039,981,1000,218,18039,962,8066,676,453,140,7613,659,14664,895,3149,409,11515,805
BK37,Park Slope-Gowanus,53744,1352,31981,1103,569,196,31412,1112,14768,844,422,139,14346,834,6995,614,1142,248,5853,564
BK38,DUMBO-Vinegar Hill-Downtown Brooklyn-Boerum Hill,25337,980,13252,689,248,102,13004,687,6065,480,537,182,5528,452,6020,639,1570,288,4450,533
BK40,Windsor Terrace,15810,669,9023,609,146,97,8877,599,4479,468,249,130,4230,463,2308,359,401,157,1907,318
BK41,Kensington-Ocean Parkway,22754,983,9494,666,396,151,9098,654,6956,551,443,189,6513,534,6304,560,1205,233,5099,520
BK42,Flatbush,69544,1787,34036,1287,925,202,33111,1286,16111,930,891,200,15220,898,19397,1077,2785,374,16612,1015
BK43,Midwood,31123,1068,12245,661,185,81,12060,658,9209,656,490,173,8719,646,9669,692,1616,305,8053,658
BK44,Madison,25690,873,13220,621,461,139,12759,612,5216,483,240,92,4976,471,7254,553,924,209,6330,519
BK45,Georgetown-Marine Park-Bergen Beach-Mill Basin,29484,995,15194,693,379,118,14815,696,6520,530,283,114,6237,515,7770,642,961,194,6809,608
BK46,Ocean Parkway South,11319,702,4644,421,79,70,4565,420,3316,390,116,62,3200,388,3359,346,389,114,2970,334
BK50,Canarsie,56852,1473,30672,1100,720,169,29952,1088,11480,725,616,165,10864,709,14700,839,2115,279,12585,779
BK58,Flatlands,45544,1239,23352,938,524,134,22828,928,11224,716,539,142,10685,709,10968,672,1409,224,9559,651
BK60,Prospect Lefferts Gardens-Wingate,45330,1476,22188,1059,640,171,21548,1054,11158,864,716,192,10442,838,11984,923,1971,412,10013,836
BK61,Crown Heights North,66064,1755,31571,1255,1256,248,30315,1238,14383,852,976,219,13407,823,20110,1141,3591,426,16519,1071
BK63,Crown Heights South,26030,1077,11275,713,440,136,10835,703,6599,604,265,94,6334,593,8156,721,1076,227,7080,692
BK64,Prospect Heights,15817,770,9876,693,109,61,9767,692,3893,451,173,93,3720,430,2048,327,160,92,1888,316
BK68,Fort Greene,18979,838,9453,648,267,104,9186,653,5023,462,137,92,4886,457,4503,494,1110,226,3393,457
BK69,Clinton Hill,27232,1141,13329,815,193,97,13136,822,7366,713,280,98,7086,708,6537,637,793,203,5744,615
BK72,Williamsburg,14968,665,2799,313,142,106,2657,301,5503,437,201,106,5302,431,6666,489,498,156,6168,487
BK73,North Side-South Side,33780,1101,16686,881,297,121,16389,883,9816,715,262,117,9554,702,7278,648,1351,276,5927,589
BK75,Bedford,43264,1417,19214,952,715,192,18499,935,10009,717,646,166,9363,695,14041,876,2795,364,11246,816
BK76,Greenpoint,25483,977,15649,813,287,104,15362,813,5184,519,118,68,5066,515,4650,553,473,156,4177,515
BK77,Bushwick North,42665,1430,21226,1159,442,140,20784,1151,7413,618,331,98,7082,610,14026,928,1973,312,12053,874
BK78,Bushwick South,47032,1681,21317,1146,699,175,20618,1130,10281,739,734,212,9547,721,15434,991,2956,393,12478,899
BK79,Ocean Hill,19392,943,8889,625,544,160,8345,608,3766,460,257,105,3509,451,6737,632,1433,299,5304,537
BK81,Brownsville,32970,1203,13612,750,342,117,13270,744,5757,577,640,180,5117,531,13601,950,2273,377,11328,899
BK82,East New York,55920,1634,24329,1097,878,199,23451,1087,9800,699,634,150,9166,684,21791,1155,3740,449,18051,1084
BK83,Cypress Hills-City Line,30683,1244,15041,889,258,101,14783,889,4514,457,185,83,4329,449,11128,766,1007,213,10121,738
BK85,East New York (Pennsylvania Ave),17928,830,7401,585,271,115,7130,575,4180,452,191,84,3989,445,6347,561,1048,214,5299,521
BK88,Borough Park,55830,1640,20718,989,573,151,20145,980,16356,963,699,194,15657,937,18756,922,1993,307,16763,888
BK90,East Williamsburg,24500,1021,12556,746,367,124,12189,732,6441,628,213,89,6228,617,5503,563,1143,244,4360,537
BK91,East Flatbush-Farragut,34351,1247,18757,872,468,154,18289,862,7098,571,314,115,6784,553,8496,680,1102,209,7394,640
BK93,Starrett City,6889,641,3320,443,320,157,3000,418,1059,302,112,79,947,281,2510,617,485,236,2025,597
BK95,Erasmus,19450,1004,9804,674,174,88,9630,674,4092,473,170,76,3922,461,5554,589,704,217,4850,544
BK96,Rugby-Remsen Village,36413,1277,19181,934,404,146,18777,941,7529,616,337,126,7192,595,9703,772,2032,377,7671,652
BK99,park-cemetery-etc-Brooklyn,271,146,165,102,0,40,165,102,41,57,22,48,19,49,65,66,65,66,0,40
BX01,Claremont-Bathgate,18510,892,5733,525,341,141,5392,505,4795,513,352,122,4443,511,7982,656,2772,420,5210,553
BX03,Eastchester-Edenwald-Baychester,22674,1205,11414,832,311,151,11103,837,4564,543,197,96,4367,541,6696,742,1611,350,5085,662
BX05,Bedford Park-Fordham North,33902,1444,14467,987,635,178,13832,985,8664,827,591,172,8073,809,10771,885,3079,474,7692,785
BX06,Belmont,16635,920,5124,593,166,80,4958,585,5968,597,419,143,5549,602,5543,553,1607,310,3936,493
BX07,Bronxdale,21548,1069,10493,835,684,214,9809,851,4720,542,559,195,4161,519,6335,628,1808,337,4527,519
BX08,West Farms-Bronx River,22504,1221,10250,866,349,136,9901,878,5310,618,296,134,5014,602,6944,699,1451,325,5493,652
BX09,Soundview-Castle Hill-Clason Point-Harding Park,33593,1416,16229,904,586,178,15643,898,5781,605,678,187,5103,569,11583,945,2980,435,8603,856
BX10,Pelham Bay-Country Club-City Island,16461,1052,9839,845,370,173,9469,811,3074,465,148,86,2926,452,3548,508,689,198,2859,477
BX13,Co-op City,26661,1473,13915,980,831,319,13084,986,5321,744,370,184,4951,731,7425,774,2100,512,5325,643
BX14,East Concourse-Concourse Village,39297,1501,16459,1147,533,195,15926,1150,9928,800,829,247,9099,788,12910,964,3321,487,9589,788
BX17,East Tremont,25185,1173,9234,849,511,164,8723,823,5660,565,531,157,5129,552,10291,801,3456,439,6835,687
BX22,North Riverdale-Fieldston-Riverdale,16165,837,8501,566,127,83,8374,571,4645,510,234,93,4411,503,3019,390,537,195,2482,339
BX26,Highbridge,23026,933,8420,642,486,174,7934,631,6706,601,738,218,5968,574,7900,651,2610,421,5290,548
BX27,Hunts Point,15735,865,5662,506,395,160,5267,500,3928,452,476,155,3452,427,6145,587,2041,313,4104,503
BX28,Van Cortlandt Village,32024,1293,14567,871,789,212,13778,870,9406,747,567,183,8839,713,8051,789,1675,328,6376,676
BX29,Spuyten Duyvil-Kingsbridge,18182,805,10216,620,386,118,9830,619,3765,439,278,112,3487,430,4201,481,856,229,3345,447
BX30,Kingsbridge Heights,20106,1145,8850,908,266,122,8584,900,5295,626,310,150,4985,608,5961,616,1432,297,4529,555
BX31,Allerton-Pelham Gardens,19659,998,10390,676,423,150,9967,667,3905,440,383,119,3522,419,5364,524,1358,243,4006,486
BX33,Longwood,14955,930,6192,643,156,80,6036,644,3000,427,182,106,2818,413,5763,599,1956,368,3807,472
BX34,Melrose South-Mott Haven North,22971,1122,8331,839,454,159,7877,849,6328,702,636,222,5692,669,8312,777,2883,429,5429,669
BX35,Morrisania-Melrose,23422,1025,8813,748,600,185,8213,744,5859,575,578,198,5281,542,8750,665,2407,382,6343,592
BX36,University Heights-Morris Heights,35099,1354,13025,960,990,237,12035,937,10766,808,1159,266,9607,753,11308,861,3467,423,7841,754
BX37,Van Nest-Morris Park-Westchester Square,18473,936,9570,666,382,138,9188,656,3772,436,257,101,3515,429,5131,519,963,199,4168,490
BX39,Mott Haven-Port Morris,31665,1271,10946,847,736,204,10210,814,8446,695,922,219,7524,641,12273,788,4749,528,7524,626
BX40,Fordham South,15743,1017,5979,666,231,116,5748,650,4602,571,479,191,4123,528,5162,578,1758,289,3404,510
BX41,Mount Hope,33479,1314,13383,797,693,192,12690,792,9498,789,753,182,8745,775,10598,768,3199,403,7399,648
BX43,Norwood,25919,1306,12326,833,598,192,11728,822,5423,586,493,185,4930,558,8170,769,2072,328,6098,700
BX44,Williamsbridge-Olinville,37566,1342,18369,920,902,201,17467,905,8440,627,658,173,7782,602,10757,766,2972,375,7785,655
BX46,Parkchester,19832,784,10841,701,311,123,10530,714,4005,487,282,124,3723,482,4986,614,1029,252,3957,541
BX49,Pelham Parkway,19482,946,10446,750,303,132,10143,715,3567,430,349,150,3218,423,5469,498,866,235,4603,447
BX52,Schuylerville-Throgs Neck-Edgewater Park,28947,1196,15739,933,672,208,15067,911,6044,610,320,118,5724,594,7164,680,1594,307,5570,595
BX55,Soundview-Bruckner,21998,1109,9376,835,285,124,9091,820,4984,543,247,101,4737,525,7638,622,1505,303,6133,574
BX59,Westchester-Unionport,17283,986,8736,631,258,111,8478,623,3069,467,140,80,2929,463,5478,648,895,220,4583,610
BX62,Woodlawn-Wakefield,29430,1168,15985,885,415,132,15570,885,6238,577,280,119,5958,566,7207,653,1354,275,5853,609
BX63,West Concourse,25154,1084,10698,829,724,205,9974,842,6570,631,623,253,5947,578,7886,746,2435,392,5451,638
BX75,Crotona Park East,11679,725,4464,441,217,99,4247,444,2854,409,199,89,2655,398,4361,475,1138,239,3223,446
BX98,Rikers Island,0,17,0,17,0,17,0,17,0,17,0,17,0,17,0,17,0,17,0,17
BX99,park-cemetery-etc-Bronx,877,193,408,104,0,32,408,104,235,83,1,29,234,84,234,108,44,53,190,99
MN01,Marble Hill-Inwood,34577,1640,16158,1307,513,175,15645,1305,10688,893,624,205,10064,891,7731,847,2166,393,5565,743
MN03,Central Harlem North-Polo Grounds,52087,1707,22168,1072,1416,301,20752,1061,13750,987,1078,233,12672,958,16169,1094,4282,545,11887,977
MN04,Hamilton Heights,35394,1565,16155,1176,608,230,15547,1158,9894,892,649,213,9245,855,9345,872,2292,463,7053,795
MN06,Manhattanville,16011,979,6314,788,180,88,6134,790,4385,577,443,177,3942,559,5312,566,1297,301,4015,508
MN09,Morningside Heights,42323,2031,13441,872,601,211,12840,874,14407,1219,669,205,13738,1178,14475,1425,1507,684,12968,1292
MN11,Central Harlem South,32528,1182,15205,841,455,135,14750,845,7481,696,350,129,7131,675,9842,824,1931,347,7911,786
MN12,Upper West Side,91761,2254,50611,1713,1104,274,49507,1706,25513,1330,1201,306,24312,1309,15637,1266,3398,525,12239,1163
MN13,Hudson Yards-Chelsea-Flat Iron-Union Square,54936,1562,33265,1338,653,201,32612,1327,13405,995,656,181,12749,993,8266,781,1781,353,6485,696
MN14,Lincoln Square,41109,1509,24087,1206,507,186,23580,1203,10281,895,542,227,9739,855,6741,766,875,313,5866,720
MN15,Clinton,35240,1300,20170,1126,712,227,19458,1111,10137,807,599,232,9538,790,4933,605,823,275,4110,572
MN17,Midtown-Midtown South,23173,1025,12909,799,308,158,12601,799,6389,599,230,95,6159,592,3875,534,435,151,3440,515
MN19,Turtle Bay-East Midtown,35508,1420,23866,1196,480,168,23386,1196,7440,762,147,116,7293,755,4202,607,510,184,3692,577
MN20,Murray Hill-Kips Bay,39163,1731,24174,1454,419,189,23755,1438,8918,832,495,274,8423,831,6071,794,690,290,5381,726
MN21,Gramercy,21356,1160,12690,848,142,79,12548,847,5346,674,149,96,5197,669,3320,778,432,174,2888,755
MN22,East Village,36783,1799,19034,1111,365,156,18669,1113,11451,970,404,140,11047,953,6298,1433,687,185,5611,1433
MN23,West Village,52305,1669,30628,1236,746,260,29882,1215,14854,1155,586,192,14268,1124,6823,835,689,205,6134,799
MN24,SoHo-TriBeCa-Civic Center-Little Italy,30267,1333,16794,884,360,138,16434,888,8514,873,282,120,8232,872,4959,692,483,167,4476,674
MN25,Battery Park City-Lower Manhattan,30089,1212,19708,980,240,141,19468,985,6607,720,128,84,6479,717,3774,550,311,148,3463,531
MN27,Chinatown,31268,1430,14539,982,198,94,14341,978,8297,786,251,105,8046,776,8432,715,1564,318,6868,637
MN28,Lower East Side,49097,1580,20894,1139,614,170,20280,1137,11651,900,604,183,11047,869,16552,1090,4679,529,11873,959
MN31,Lenox Hill-Roosevelt Island,56469,1958,37419,1641,761,256,36658,1616,10660,959,378,154,10282,949,8390,885,1322,340,7068,792
MN32,Yorkville,56312,1698,36615,1610,711,234,35904,1612,12943,1095,356,154,12587,1085,6754,719,1047,265,5707,652
MN33,East Harlem South,40233,1539,18269,1157,597,157,17672,1161,9371,811,587,174,8784,804,12593,992,2815,437,9778,925
MN34,East Harlem North,38093,1544,15393,1082,693,194,14700,1082,8508,829,835,242,7673,785,14192,1063,4049,560,10143,899
MN35,Washington Heights North,48212,1720,22028,1239,577,177,21451,1216,14862,994,693,212,14169,966,11322,996,2165,364,9157,938
MN36,Washington Heights South,62336,2244,26166,1552,1159,281,25007,1540,19590,1306,1027,251,18563,1273,16580,1231,4395,678,12185,1046
MN40,Upper East Side-Carnegie Hill,33313,1216,19719,939,467,156,19252,938,6823,599,208,93,6615,595,6771,581,469,150,6302,566
MN50,Stuyvesant Town-Cooper Village,16195,984,9575,849,77,88,9498,838,3739,696,65,63,3674,686,2881,841,526,231,2355,795
MN99,park-cemetery-etc-Manhattan,1259,487,40,46,0,32,40,46,177,111,11,35,166,110,1042,473,497,311,545,330
QN01,South Jamaica,22681,1073,10976,707,359,138,10617,705,5575,521,318,128,5257,498,6130,599,1358,276,4772,528
QN02,Springfield Gardens North,16477,1152,8791,766,309,163,8482,734,4257,626,228,114,4029,622,3429,723,1215,445,2214,465
QN03,Springfield Gardens South-Brookville,12961,823,7008,485,189,83,6819,489,2901,431,121,80,2780,408,3052,474,695,220,2357,393
QN05,Rosedale,18049,890,10529,666,223,108,10306,678,4368,488,140,97,4228,487,3152,485,387,133,2765,455
QN06,Jamaica Estates-Holliswood,16089,738,8833,577,290,135,8543,565,3448,427,240,123,3208,427,3808,481,690,236,3118,431
QN07,Hollis,14524,777,6943,502,384,120,6559,502,4398,498,261,97,4137,496,3183,357,607,141,2576,329
QN08,St. Albans,32600,1136,18503,887,694,152,17809,878,7638,570,406,135,7232,553,6459,543,1440,235,5019,473
QN10,Breezy Point-Belle Harbor-Rockaway Park-Broad Channel,17573,837,9002,590,328,119,8674,583,4050,440,254,123,3796,422,4521,542,1281,338,3240,395
QN12,Hammels-Arverne-Edgemere,20667,952,8991,667,398,162,8593,642,4596,508,589,168,4007,464,7080,673,1663,348,5417,576
QN15,Far Rockaway-Bayswater,28257,1374,13798,986,835,230,12963,991,6340,676,522,219,5818,657,8119,719,1941,314,6178,660
QN17,Forest Hills,55065,1453,31450,1132,796,200,30654,1129,12144,849,608,218,11536,808,11471,861,2091,314,9380,822
QN18,Rego Park,18513,726,10580,606,235,96,10345,612,3876,406,135,79,3741,394,4057,422,504,142,3553,397
QN19,Glendale,20559,919,11073,637,240,109,10833,634,3707,406,73,46,3634,404,5779,555,812,170,4967,522
QN20,Ridgewood,47224,1427,25514,1081,425,129,25089,1075,8829,635,400,143,8429,619,12881,839,1580,265,11301,812
QN21,Middle Village,24534,948,14084,695,371,105,13713,699,4537,421,155,73,4382,419,5913,522,892,186,5021,498
QN22,Flushing,47279,1787,22304,1294,579,202,21725,1297,12608,998,566,186,12042,967,12367,922,1777,321,10590,871
QN23,College Point,15505,928,8256,663,331,143,7925,652,3673,461,165,90,3508,451,3576,444,555,185,3021,408
QN25,Corona,35339,1668,16379,1076,790,249,15589,1071,10499,951,579,186,9920,941,8461,766,1456,376,7005,690
QN26,North Corona,35510,1864,18050,1314,651,175,17399,1308,9758,845,705,210,9053,795,7702,644,1092,223,6610,610
QN27,East Elmhurst,15535,932,8346,663,206,87,8140,655,3360,476,253,105,3107,455,3829,438,605,176,3224,388
QN28,Jackson Heights,72875,2169,37503,1563,944,245,36559,1561,17285,1188,871,251,16414,1162,18087,1089,2313,398,15774,1027
QN29,Elmhurst,59168,2057,30965,1479,484,155,30481,1474,11445,884,615,175,10830,857,16758,1059,1667,300,15091,1020
QN30,Maspeth,18623,819,10053,555,360,117,9693,546,3901,370,227,100,3674,358,4669,395,633,156,4036,362
QN31,Hunters Point-Sunnyside-West Maspeth,44598,1407,24658,1132,542,177,24116,1121,11504,825,574,173,10930,799,8436,754,1393,284,7043,691
QN33,Cambria Heights,13045,713,7036,492,93,55,6943,489,3045,386,184,85,2861,364,2964,401,451,147,2513,374
QN34,Queens Village,38467,1252,19924,898,780,190,19144,886,10077,682,704,206,9373,659,8466,664,1502,265,6964,578
QN35,Briarwood-Jamaica Hills,26211,1080,13228,735,348,138,12880,726,6382,598,432,152,5950,586,6601,602,1054,233,5547,540
QN37,Kew Gardens Hills,22744,995,10692,598,437,153,10255,596,6091,604,339,176,5752,582,5961,733,983,229,4978,706
QN38,Pomonok-Flushing Heights-Hillcrest,21822,987,8369,657,438,195,7931,631,7356,731,369,158,6987,692,6097,592,1039,266,5058,574
QN41,Fresh Meadows-Utopia,11508,686,5739,510,140,70,5599,506,2919,393,86,65,2833,391,2850,395,377,147,2473,366
QN42,Oakland Gardens,17851,708,9918,582,224,119,9694,576,3691,411,299,141,3392,412,4242,459,469,142,3773,453
QN43,Bellerose,16625,855,8772,678,283,125,8489,677,3875,427,177,94,3698,407,3978,444,858,196,3120,421
QN44,Glen Oaks-Floral Park-New Hyde Park,13267,762,7280,552,193,79,7087,547,3116,428,97,79,3019,415,2871,384,581,151,2290,354
QN45,Douglas Manor-Douglaston-Little Neck,15844,883,9042,635,159,107,8883,628,3748,411,113,66,3635,407,3054,456,373,127,2681,451
QN46,Bayside-Bayside Hills,29587,979,15485,657,357,129,15128,660,7303,572,303,120,7000,564,6799,581,1178,318,5621,487
QN47,Ft. Totten-Bay Terrace-Clearview,13770,1039,6898,593,223,119,6675,603,3581,524,68,63,3513,521,3291,621,370,153,2921,619
QN48,Auburndale,13394,662,6826,460,177,92,6649,454,2882,336,119,69,2763,337,3686,380,433,157,3253,361
QN49,Whitestone,19621,891,10313,601,264,115,10049,602,5046,543,250,109,4796,536,4262,468,486,149,3776,436
QN50,Elmhurst-Maspeth,17864,918,10051,792,95,54,9956,798,3255,381,91,63,3164,380,4558,497,537,181,4021,468
QN51,Murray Hill,34454,1324,17386,952,476,156,16910,948,8138,704,307,116,7831,700,8930,722,1050,243,7880,687
QN52,East Flushing,18882,904,9109,619,208,92,8901,616,4260,426,265,107,3995,417,5513,523,433,140,5080,502
QN53,Woodhaven,39091,1325,19249,839,782,191,18467,818,9744,697,760,186,8984,681,10098,687,1973,273,8125,633
QN54,Richmond Hill,43743,1470,21403,976,764,164,20639,967,11067,734,727,185,10340,712,11273,694,1854,286,9419,628
QN55,South Ozone Park,54305,1729,26866,1235,723,176,26143,1226,13595,858,748,178,12847,840,13844,844,2046,326,11798,780
QN56,Ozone Park,14416,905,7214,655,254,119,6960,653,3709,497,335,123,3374,479,3493,402,854,207,2639,332
QN57,Lindenwood-Howard Beach,17030,960,9112,649,343,153,8769,646,3732,557,334,147,3398,530,4186,600,849,232,3337,561
QN60,Kew Gardens,15981,904,8572,660,228,80,8344,660,3772,453,235,120,3537,443,3637,527,443,130,3194,500
QN61,Jamaica,33383,1249,16116,827,757,180,15359,811,7692,720,644,176,7048,707,9575,723,1693,299,7882,671
QN62,Queensboro Hill,13876,789,6750,524,283,120,6467,515,3282,391,87,64,3195,385,3844,381,322,102,3522,373
QN63,Woodside,31306,1361,17097,1050,232,128,16865,1051,7108,649,358,159,6750,624,7101,675,956,262,6145,630
QN66,Laurelton,15795,769,8626,555,275,96,8351,556,3713,368,179,82,3534,357,3456,397,842,200,2614,362
QN68,Queensbridge-Ravenswood-Long Island City,12432,675,5522,486,309,119,5213,460,3031,367,285,116,2746,363,3879,443,795,168,3084,403
QN70,Astoria,55267,1526,29963,1161,595,158,29368,1156,15361,905,683,175,14678,886,9943,713,1714,304,8229,647
QN71,Old Astoria,19359,951,9428,750,169,84,9259,748,5499,575,299,118,5200,557,4432,488,1039,212,3393,449
QN72,Steinway,35247,1149,18979,859,612,176,18367,868,9112,653,456,152,8656,643,7156,668,1416,253,5740,639
QN76,Baisley Park,21883,932,11264,651,597,151,10667,655,5063,461,361,107,4702,452,5556,491,1312,236,4244,424
QN98,Airport,0,17,0,17,0,17,0,17,0,17,0,17,0,17,0,17,0,17,0,17
QN99,park-cemetery-etc-Queens,245,112,131,68,0,48,131,68,61,52,4,47,57,53,53,70,12,50,41,69
SI01,Annadale-Huguenot-Prince's Bay-Eltingville,18696,758,9434,581,257,104,9177,579,4308,422,111,72,4197,412,4954,464,721,178,4233,445
SI05,New Springville-Bloomfield-Travis,24653,1136,12862,807,335,126,12527,807,4998,462,422,161,4576,441,6793,649,1067,228,5726,630
SI07,Westerleigh,15285,675,8040,552,195,80,7845,551,3279,373,160,92,3119,368,3966,445,797,208,3169,395
SI08,Grymes Hill-Clifton-Fox Hills,15885,1103,7152,549,228,122,6924,535,4595,833,199,98,4396,832,4138,584,740,234,3398,512
SI11,Charleston-Richmond Valley-Tottenville,14426,794,8072,644,204,92,7868,641,2570,329,137,58,2433,322,3784,441,671,210,3113,392
SI12,Mariner's Harbor-Arlington-Port Ivory-Graniteville,19561,895,9398,652,287,109,9111,657,3744,474,248,103,3496,462,6419,672,1318,276,5101,663
SI14,Grasmere-Arrochar-Ft. Wadsworth,9257,517,4671,386,76,43,4595,385,1852,275,158,68,1694,262,2734,344,497,133,2237,318
SI22,West New Brighton-New Brighton-St. George,19227,969,8356,650,243,125,8113,650,4836,540,275,96,4561,533,6035,623,1146,247,4889,555
SI24,Todt Hill-Emerson Hill-Heartland Village-Lighthouse Hill,20103,858,10734,676,328,130,10406,674,3989,473,186,85,3803,473,5380,499,869,208,4511,447
SI25,Oakwood-Oakwood Beach,13174,735,7051,546,153,84,6898,547,2835,402,193,132,2642,382,3288,451,729,201,2559,416
SI28,Port Richmond,11989,755,5840,523,122,64,5718,518,2403,385,124,64,2279,383,3746,485,579,137,3167,484
SI32,Rossville-Woodrow,12929,656,6946,583,175,124,6771,575,2358,346,38,37,2320,342,3625,415,375,151,3250,390
SI35,New Brighton-Silver Lake,11487,649,5691,463,148,72,5543,463,2323,348,74,44,2249,345,3473,448,596,175,2877,409
SI36,Old Town-Dongan Hills-South Beach,15651,849,7508,583,258,107,7250,583,3312,454,356,138,2956,420,4831,555,1054,224,3777,494
SI37,Stapleton-Rosebank,16706,842,8064,591,288,114,7776,581,3346,400,192,82,3154,393,5296,579,1164,256,4132,523
SI45,New Dorp-Midland Beach,13476,726,7068,535,283,108,6785,532,2771,384,141,107,2630,369,3637,418,767,203,2870,375
SI48,Arden Heights,16791,674,9169,557,272,104,8897,557,3255,425,112,90,3143,396,4367,473,809,214,3558,409
SI54,Great Kills,27776,858,14963,764,565,179,14398,747,5652,511,399,129,5253,500,7161,564,1340,259,5821,525
SI99,park-cemetery-etc-Staten Island,0,17,0,17,0,17,0,17,0,17,0,17,0,17,0,17,0,17,0,17
